Amazon	AMZN	
Anheuser Busch InBev BUD	
Apple	AAPL	
Berkshire Hathaway	BRK.B	
Boeing	BA	
British Petroleum	BP	
Costco	COST	
Disney	DIS	
Exxon Mobil	
Facebook	FB	
Ford	F	
General Electric	GE	
Home Depot	HD
IBM	IBM	
Intel	INTC	
JPMorgan Chase	
Johnson & Johnson JNJ	
Kraft Foods	KHC	
Lockheed	LMT	
Merck	MRK	
Microsoft	MSFT	
NVIDIA	NVDA	
Netflix	NFLX	
Oracle	ORCL	
PepsiCo	PEP	
Pfizer	PFE	
Qualcomm	QCOM
Royal Caribbean	RCL	
Slack	WORK
Spotify	SPOT	
Starbucks	SBUX	
Tesla	TSLA	
Twitter	TWTR	
Uber	UBER	
Verizon	VZ
Walmart	WMT	
Xilinx	XLNX
YETI	YETI	
Zoom	ZM	
